S-------
B-B--BBB
----B---
-BBBB---
----B---
BBB-B---
--------
-------E